R 1920 1080
NO ./textures/eagle.xpm
SO ./textures/redbrick.xpm
WE ./textures/greystone.xpm
EA ./textures/purplestone.xpm
S ./textures/pillar.xpm
F 220,100,0
C 225,30,0

111111111111111111111111111111
122222222222222222222222222221
122222222222222222222222222221
122222222222222222222222222221
122222222222222222222222222221
122222222222222222222222222221
122222222222222222222222222221
122222222222222222222222222221
122222222222222222222222222221
122222222222222222222222222221
122222222222222222222222222221
122222222222222222222222222221
122222222222222222222222222221
122222222222222222222222222221
122222222222222222222222222221
122222222222222N22222222222221
122222222222222222222222222221
122222222222222222222222222221
122222222222222222222222222221
122222222222222222222222222221
122222222222222222222222222221
122222222222222222222222222221
122222222222222222222222222221
122222222222222222222222222221
122222222222222222222222222221
122222222222222222222222222221
122222222222222222222222222221
122222222222222222222222222221
122222222222222222222222222221
111111111111111111111111111111