R 600 500
NO ./textures/eagle.xpm
SO ./textures/redbrick.xpm
WE ./textures/greystone.xpm
EA ./textures/purplestone.xpm
S ./textures/pillar.xpm
F 220,100,0
C 225,30,0

111111111111111111111111111111
122020200200002000220000220201
120000020000002022200022022221
120000002020020000022000000021
120020220000020002202002200001
120220200200220000020220200001
100000002200002200200020000001
100002202020000020020020002001
122002020002000000000020222221
120200000000200200000020200021
102220000000002222220002202001
122000202220020020202200002001
100002220000000022200002202221
100000200200202000000000002001
100000200202200020000020002001
100020022020000N00000000000001
102022022002000220202200022201
122002200002020000220002020001
120200200000000000000020002001
100020000200000000200202000021
102000000200020200020200200201
100200000020002022000000000021
102002222000002222000222000001
100000002200202020000202000001
120000020022000200000220000021
100020200200000000000200020001
100000000220222202020200000001
102020000000000002002200022201
100200000200022200222002200221
111111111111111111111111111111