R 520 480
NO ./textures/eagle.xpm
SO ./textures/redbrick.xpm
WE ./textures/greystone.xpm
EA ./textures/purplestone.xpm
S ./textures/pillar.xpm
F 220,100,0
C 225,30,0

1111111111111111111111111111111111111111111111111111111111111111
1222222222222222222222222222222222222222222222222222222222222221
1222222222222222222222222222222222222222222222222222222222222221
1222222222222222222222222222222222222222222222222222222222222221
1222222222222222222222222222222222222222222222222222222222222221
1222222222222222222222222222222222222222222222222222222222222221
1222222222222222222222222222222222222222222222222222222222222221
1222222222222222222222222222222222222222222222222222222222222221
1222222222222222222222222222222222222222222222222222222222222221
1222222222222222222222222222222222222222222222222222222222222221
1222222222222222222222222222222222222222222222222222222222222221
1222222222222222222222222222222222222222222222222222222222222221
1222222222222222222222222222222222222222222222222222222222222221
1222222222222222222222222222222222222222222222222222222222222221
1222222222222222222222222222222222222222222222222222222222222221
1222222222222222222222222222222222222222222222222222222222222221
1222222222222222222222222222222222222222222222222222222222222221
1222222222222222222222222222222222222222222222222222222222222221
1222222222222222222222222222222222222222222222222222222222222221
1222222222222222222222222222222222222222222222222222222222222221
1222222222222222222222222222222222222222222222222222222222222221
1222222222222222222222222222222222222222222222222222222222222221
1222222222222222222222222222222222222222222222222222222222222221
1222222222222222222222222222222222222222222222222222222222222221
1222222222222222222222222222222222222222222222222222222222222221
1222222222222222222222222222222222222222222222222222222222222221
1222222222222222222222222222222222222222222222222222222222222221
1222222222222222222222222222222222222222222222222222222222222221
1222222222222222222222222222222222222222222222222222222222222221
1222222222222222222222222222222222222222222222222222222222222221
1222222222222222222222222222222222222222222222222222222222222221
1222222222222222222222222222222222222222222222222222222222222221
12222222222222222222222222222222N2222222222222222222222222222221
1222222222222222222222222222222222222222222222222222222222222221
1222222222222222222222222222222222222222222222222222222222222221
1222222222222222222222222222222222222222222222222222222222222221
1222222222222222222222222222222222222222222222222222222222222221
1222222222222222222222222222222222222222222222222222222222222221
1222222222222222222222222222222222222222222222222222222222222221
1222222222222222222222222222222222222222222222222222222222222221
1222222222222222222222222222222222222222222222222222222222222221
1222222222222222222222222222222222222222222222222222222222222221
1222222222222222222222222222222222222222222222222222222222222221
1222222222222222222222222222222222222222222222222222222222222221
1222222222222222222222222222222222222222222222222222222222222221
1222222222222222222222222222222222222222222222222222222222222221
1222222222222222222222222222222222222222222222222222222222222221
1222222222222222222222222222222222222222222222222222222222222221
1222222222222222222222222222222222222222222222222222222222222221
1222222222222222222222222222222222222222222222222222222222222221
1222222222222222222222222222222222222222222222222222222222222221
1222222222222222222222222222222222222222222222222222222222222221
1222222222222222222222222222222222222222222222222222222222222221
1222222222222222222222222222222222222222222222222222222222222221
1222222222222222222222222222222222222222222222222222222222222221
1222222222222222222222222222222222222222222222222222222222222221
1222222222222222222222222222222222222222222222222222222222222221
1222222222222222222222222222222222222222222222222222222222222221
1222222222222222222222222222222222222222222222222222222222222221
1222222222222222222222222222222222222222222222222222222222222221
1222222222222222222222222222222222222222222222222222222222222221
1222222222222222222222222222222222222222222222222222222222222221
1222222222222222222222222222222222222222222222222222222222222221
1111111111111111111111111111111111111111111111111111111111111111