R  820 600

NO ./textures/eagle.xpm
SO ./textures/eagle.xpm
WE ./textures/eagle.xpm
EA ./textures/eagle.xpm

S  ./textures/barrel.xpm
F  240,240,240
C  30,30,30

        1111111111111111111111111
        1000000000110000222000001
        1011000001110000000000001
        1001000000000000000000001
111111111011000001110000000000001
100000000011000001110111101111111
11110100000000000000000010001
1111010000001111111010010001
11220000000010000001000010001
10000000000010111101000010001
10000000000010100101010010001
11000011100010101101111000111
11110111 10000100001111010N01
11111111 111111 1111111111111
