R  820 600

NO ./textures/eagle.xpm
SO ./textures/eagle.xpm
WE ./textures/eagle.xpm
EA ./textures/eagle.xpm

S  ./textures/barrel.xpm
F  240,240,240
C  30,30,30

1 1111111111111111111111111111111
1       1000000000110000222000001
1       1011000001110000000000001
1       1001000000000000000000001
11111 111011000001110000000000001
100000000011000001110111111111111
11110111111111011100000000001
11110111111111011101010010001
1100 222 10101011100000010001
10000000 00000101100000010001
10000000 00000000001010010001
11 0022011010100111101111000111
11110111 1110101 1011110100N1
11111111 1111111 11111111111
