R  820 600

NO ./textures/eagle.xpm
SO ./textures/eagle.xpm
WE ./textures/eagle.xpm
EA ./textures/eagle.xpm

S  ./textures/barrel.xpm
F  240,240,240
C  30,30,30

N       1111111111111111111111111
        1000000000110000222000001
        1011000001110000000000001
        1001000000000000000000001
111111111011000001110000000000001
100000000011000001110111101111111
11110111111111011100000010001
11110111111111011101010010001
11220000110101011100000010001
10000000000000001100000010001
10000000000000001101010010001
110000111010101111101111000111
11110111 1110101 101111010001
11111111 1111111 111111111111
