R 1920 1080

NO ./textures/eagle.xpm
SO ./textures/colorstone.xpm
WE ./textures/mossy.xpm
EA ./textures/redbrick.xpm
S ./textures/barrel.xpm
F 220,100,0
C 225,30,0

1111111111      11111111111111
1000000001      1    12      1
1000000001      1  1   1    N 1
1000000001      1    12      1
1000000001      11111111111111
1000000001
1000000001
100000000000000000001111110001
100000000000000000001000010001
100000000000000000001000010001
100000000000000000001000010001
100000000000000000001121110001
100000000000000000000000000001
100000000000000000000000000001
100000000000000000000000000001
111111111111111111111111111111
